+-+-+-+-+-+-+-+-+-+-+-+-+-+-+-+-+-+-+-+-+-+-+-+-+-+
  |   |   |       |     |   |   |   |       |     |
+ + + + + + + +-+ +-+ + +-+ +-+ + + + +-+-+ + +-+ +
| | | | | | | |   |   |   | |     |   |     |   | |
+ + + + + +-+ + +-+ +-+-+ + + +-+-+-+-+ +-+-+-+ + +
|   |   |   | |   | |       |     |   | |   |   | |
+-+-+-+-+-+ + +-+-+ + +-+-+-+-+-+ +-+ + + + +-+-+ +
|     |     |       |   |   |   |   | |   |       |
+ +-+ + + +-+ +-+-+-+-+ +-+ + + + + + +-+-+-+-+-+-+
| | |   |   |     |   |     | | | | | |           |
+ + + +-+-+ +-+-+ +-+ +-+-+-+ + + + + + +-+-+-+ + +
|   | |   | |         |   |   |   | | |   |   | | |
+-+-+ + + + + + +-+ +-+ + + +-+-+-+ + +-+ +-+ + + +
|   | | | |   |   |   | |   |     | |   |   |   | |
+ + + + + +-+-+-+ +-+-+ + +-+ +-+-+ + + +-+ +-+-+ +
| | | | | |   |   |   | |   | |     | | |     |   |
+ +-+ + + + + + +-+ + + +-+ + +-+ +-+-+ +-+-+ + + +
| |   | | | | | | | |     | |     |   |   |   | | |
+ + +-+ + +-+ + + + +-+-+ + +-+-+-+ + +-+ + +-+-+ +
| |     |     |   | | |   | |       | |   |     | |
+ +-+-+ +-+ +-+-+ + + + + + + +-+-+-+ + +-+-+-+ + +
|   | |   |   |   | |   | |   | |       |     | | |
+-+ + +-+ +-+ + +-+ +-+-+-+-+-+ + +-+-+-+ + +-+ + +
| |       | | |       |   |     |         | |   | |
+ +-+-+-+-+ + +-+-+-+ + + +-+ +-+-+-+-+ +-+ + +-+ +
|   |       |   |     | |     |       | |   | |   |
+-+ +-+-+-+ +-+-+ +-+-+ +-+-+-+ +-+-+-+ +-+-+ +-+-+
|     |   |       | |         |             |     |
+-+-+ + + +-+-+-+-+ + + +-+-+-+-+-+-+-+ +-+ +-+-+ +
|       |   |     |   |   |             | | | |   |
+ +-+-+-+-+ + +-+ +-+ +-+ + +-+-+-+-+-+-+ + + + +-+
|   |   |   |   | |   |     |           |     |   |
+ + + + +-+-+-+ + +-+-+ + +-+ +-+-+-+-+ +-+-+-+-+ +
| |   |   | |   |       |   | |       |   |     | |
+ +-+ +-+ + + +-+-+-+-+ +-+ + + +-+ +-+-+ + +-+ + +
|   |   | |     | |     | | | | |           |   | |
+-+ +-+-+ +-+-+ + + +-+-+ + + + +-+-+-+-+-+-+ +-+ +
| |   |   |   |   | |   | |   |   |     |   |     |
+ +-+ + +-+ + +-+-+ + + + +-+-+-+ + +-+ +-+ +-+-+-+
|     |   | | |       |   |       |   |           |
+-+ +-+-+ + + + +-+-+-+-+-+ +-+-+-+-+ +-+-+-+-+ + +
| |   | | | |   |   |   |   |       |     |   | | |
+ +-+ + + + +-+-+-+ + + + +-+ +-+-+ +-+-+ +-+ +-+ +
| |     |           | | | | | | |       | |   |   |
+ +-+-+-+-+ +-+-+-+-+-+ + + + + + + +-+ + + +-+ +-+
|     |     |   |       |   | |   | | |   |     | |
+-+-+ + +-+-+ + +-+ +-+-+-+ + + +-+ + +-+ +-+-+-+ +
|       |     |   | |     |   | |   |   | |   |   |
+ +-+-+-+ +-+-+ + + + +-+ +-+-+ + +-+-+ + +-+ + + +
|         |     |   |   |       |       |       |  
+-+-+-+-+-+-+-+-+-+-+-+-+-+-+-+-+-+-+-+-+-+-+-+-+-+